##################             
#       # .....  #                 
#       # .      #               
#       # .      #               
#    #  # .      #               
#    ####    .   #              
#    # #######   #              
#        @       #
#                #              
#       #        #              
#    #..#     .  #           
#    #..#        #             
#    #..#   .    #             
#             ####             
#       #     #..#            
#  +    #     ##.#           
#            ....#           
##################            
                         
                           
                         
                         
