##################             
#       # .....  #                 
#       # .   .  #
#       # .  .   #
#       # ..  .  #
#      ## .  .   #
#      #######   #
#        @       #
#                #              
#  #.#  #  #  #  #
#  #.#..# ####   #
#  ###..## #.#   #
#    #..#  #  #  #
#             ####             
#             #..#
#  +    ########.#
#            ....#           
##################            
                         
                           
                         
                         
